C 204,255,255        
F 51,0,0


EA ./assets/textures/east.xpm           
NO ./assets/textures/north.xpm
SO ./assets/textures/south.xpm
WE ./assets/textures/west.xpm
   
                     
    
        1111111111111111111111111
        1000000000110000000100001
        1011000001110000001 10001
        100100000000000000N100001
111111111011000001110000000000001
100000000011000001110111111111111
11110111111111011100000010001    
11110111111111011101010010001    
11000000110101011100000010001    
10000000000000001100000010001    
10000000000000001101010010001    
1100000111010101111101111000111  
11110111 1110101 101111010001    
11111111 1111111 111111111111    

                 
                      

                 